R 800 500

NO imgs/data/r_m1.xpm
SO imgs/data/r_m2.xpm
EA imgs/data/r_m3.xpm
WE imgs/data/r_m4.xpm

S imgs/data/r_m5.xpm

F 139,137,110
C 51,161,201

 11111111111111111111
1000000000100000000001
1000020001000000000001
1000000001000000020001
 111101111000000000001
    100001000001000101
 111100000000000000001111111111111111111111
10000000000000000N0000000000002000000000001
 111111111111111111111111111111111111111111
